11111111111111111111111111111111
1001C000000000000000000000000011
100100000100000011111C0000000101
10010000001000001011111000001001
10010000000000001000000100000001
10010000000000000000000000000001
100000000000000000000C0000000001
1000000C000001100000000000000001
10000000000000E10P00000100000001
10010011000001100000000000000001
1001000000000000011111000C000001
1111000C111100000000000000000001
10010000000000000000000011000001
10000011000000000000000000000001
100000000000000000111110000C0001
10010000C00000001000000100000001
10010000000000100000000110000001
11111111111111111111111111111111
