1111111111111111111111111111111111
1E0000000000000C00000C000000011111
1000000000000000111011111100001111
1011001111101111111000001101111111
1P0000000C00C0000000111000000000C1
1111111111111111111111111111111111
